5
1 1
5 5
1 4 -1
1 3 4 5 -1
1 3 5 -1
1 2 3 5 -1
1 3 5 -1